1111111111111
1001000000P01
10E0011111001
10C0110000001
1111111111111