1111111111111
1001P00000001
1000011111001
1000110000W01
1111111111111