1111111111111
1E01P00000001
1000011110001
10C0110000101
1111111111101
1111111111101