1111111111111
10010000000P1
10E0011111001
10C0110000001
1111111111111