1111111111111
1E010000000P1
1000011111001
10C0110000001
1111111111111